text	label
There's an unfamiliar charge from your company on my credit card statement that doesn't match my usual premium payment. Could you please investigate this for me?	Billing Disputes
"I've noticed a charge on my credit card from your business that I don't recognize, and it's a different amount than my typical insurance premium. Can you look into this and let me know what it's for?"	Billing Disputes
"I spotted an unidentified charge from your insurance company on my credit card bill, and it's not the same as my regular premium payment. Would you mind checking on this and explaining the charge to me?"	Billing Disputes
"I suspect I'm being charged twice for the motorcycle endorsement on my auto policy. The cost of my premium increased, but I don't see an itemized charge for the endorsement. Can you help me understand what's going on?"	Billing Disputes
"It looks like I might be getting double-billed for my motorcycle endorsement. My insurance rates went up, but the endorsement fee isn't listed as a separate item. Could you clarify this for me and make sure I'm not being overcharged?"	Billing Disputes
"I think there may be a duplicate charge for my motorcycle endorsement, as my premium has increased without the endorsement being clearly listed on my bill. Can you investigate this and explain why the price has gone up?"	Billing Disputes
"I received a notice that my insurance policy is being canceled for non-payment, but I'm almost positive I paid my premium before the due date. Could you please look into this matter and reinstate my coverage if there's been an error?"	Billing Disputes
"According to the cancellation notice I received, my insurance is being terminated for failure to pay my premium on time. However, I believe I made the payment by the deadline. Can you investigate this situation and restore my policy if a mistake has occurred?"	Billing Disputes
"I got a letter saying my insurance is being canceled because of an overdue payment, but I think I submitted the payment prior to the cutoff date. Would you be able to research this issue and reactivate my policy if it turns out there was a misunderstanding or processing error?"	Billing Disputes
"Another vehicle hit my parked car, but I didn't get any information from the other driver. What's the process for submitting a claim in this situation?"	Claims Assistance
"My parked vehicle was damaged by another car, but I don't have the details of the other driver. How should I go about filing an insurance claim?"	Claims Assistance
"Someone hit my car while it was parked, but I couldn't get their information. Can you explain what I need to do to file a claim without the other driver's details?"	Claims Assistance
"My home suffered hail damage, and I need to submit a claim. However, I'm unsure whether I should file it under my homeowners policy or my separate windstorm coverage. What would you advise?"	Claims Assistance
"Hail caused some damage to my house, and I want to file an insurance claim. Should I submit it through my homeowners policy or my windstorm policy? I'm not certain which one is appropriate for this situation."	Claims Assistance
"I have to file a claim for hail damage to my home's roof, but I don't know if it should be filed under my primary homeowners insurance or my additional windstorm policy. Can you provide guidance on which policy to use?"	Claims Assistance
"I received some correspondence about modifications to my insurance policy, but I don't fully understand what they entail. Would you be able to provide more information about these changes?"	General Inquiries
"Your company sent me a letter describing some adjustments to my policy, but the details are a bit unclear to me. Can you give me a better explanation of what these changes mean for my coverage?"	General Inquiries
"I got a letter in the mail outlining some updates to my insurance policy, but I'm unsure how they affect me. Could you clarify the implications of these changes?"	General Inquiries
"My insurance agent mentioned a ""vanishing deductible"" option, but I don't entirely grasp what that means. Can you provide some additional details about how this feature works and what benefits it offers?"	General Inquiries
"I heard something about a ""disappearing deductible"" from my insurance representative, but I'm not completely clear on the concept. Could you give me a more thorough explanation of this option and how it might impact my policy?"	General Inquiries
"I'm a bit confused about the ""disappearing deductible"" my agent brought up. Would you mind elaborating on what this entails and how it could affect my insurance coverage?"	General Inquiries
Can you provide more information about how your accident forgiveness program operates and what criteria must be met to be eligible for this benefit?	General Inquiries
I'm interested in learning more about your accident forgiveness offering. Could you explain the details of how it works and what qualifications policyholders need to satisfy to take advantage of this feature?	General Inquiries
I'd like to better understand your company's accident forgiveness option. Would you mind describing how it functions and outlining the requirements customers must fulfill to be eligible for this perk?	General Inquiries
I would like to modify the coverage limits and deductibles on my homeowners insurance policy. What choices do I have available?	Policy Administration
Can you tell me what my options are for changing the deductibles and coverage limits associated with my home insurance policy?	Policy Administration
I'm interested in adjusting the deductibles and coverage amounts for my homeowners policy. Could you outline the different possibilities I have?	Policy Administration
"As I prepare for retirement, I'm considering making some adjustments to my life insurance policy. What changes would you recommend based on my upcoming shift in lifestyle and financial needs?"	Policy Administration
"With retirement on the horizon, I'm thinking about updating my life insurance coverage to better suit my changing circumstances. Can you suggest some modifications I should make to my policy as I enter this new phase of life?"	Policy Administration
"Given my impending retirement, I believe it's time to reassess my life insurance needs and make any necessary alterations to my coverage. What advice can you offer about adapting my policy to best fit my post-retirement situation?"	Policy Administration